12 15
#######T#######
#..@...p...@..#
#.....###.....#
### ...T... ###
#.....###.....#
### ...@... ###
T.....###.....T
### ...T... ###
#..R..###.D...#
### ...@... ###
# .@. .S. .@. #
#######T#######
