16 28
#############T##############
#..........................#
#.#####.........#####......#
#............@.............#
#.....#................#...#
#.....#................#...#
#.....#...#S    S#.....#...#
T....@....# S  S #....@....T
#.........########.........#
#..........................#
#..........................#
#...#####........#####.....#
#............@.............#
#.....#......p......#......#
#..........................#
#############T##############
