12 15
###############
#   .         #
#             #
#             #
#             #
#             #
#             #
#             #
#             #
#             #
#             #
###############
