10 22
######################
#.........p..........#
####..............####
#.........@..........#
##.#..............#.##
#..T..............T..#
##.#....      ....#.##
#..@...#R    S#.....@#
#......########......#
######################
