50 15
#######T#######
# .@...p...@. #
#.....###.....#
####.......####
#.....###.....#
####...@...####
T.....###.....T
####.......####
#.....###.....#
####.......####
# .@.......@. #
#######T#######
