16 28
############################
#............p.............#
#.#####.....# #.#####......#
#............@.............#
#.....#................#...#
#.....#................#...#
#.....#...#D     #.....#...#
T....@....#      #....@....T
#.........########.........#
#..........................#
#..........................#
##.######........#####...#.#
#.R...........@..........#S#
##.#..#.............#....#.#
#..........................#
#############T##############
