12 15
 ######T#####  
p .@.......@.R 
#.....###.....#
####...T...####
#.....###.....#
####...@...####
T.....###.....T
####...T...####
#.....###.....#
####...@...####
 R.@.......@.D 
  #####T#####  
