10 10
####T#####
#....p...#
#........#
#........#
T...@....T
#........#
#........#
#........#
#.D...R..#
####T#####
