9 9
#########
#   p.  #
#       #
#       #
#       #
#       #
#       #
#       #
#########
